
F             68,68,68
C 51,204,255

NO ./textures/mossy.xpm
SO ./textures/redbrick.xpm
WE ./textures/wood.xpm
EA                         ./textures/colorstone.xpm


11111111111111111   11111
10000000000000011   11001
10000000000000001   10001
1000000000000000111110001
1000000000000000000000001
1000000000000000000000001
1000000000000000000000001
1000000000000000000000001
1000000000000000000000001
100000000001111000000001
1000000000000000000000001
1000000000000100000000001
1000000000000000000000001
1000000000000000000000001
1000000000000000000000001
1000000000000000N00000001
1000000000000000000000001
1000000000000000000000001
1000000000000000000000001
11111000000000100000000011111
    1000000001 10000000000001
11111000000000100000000011111
1000000000000000000000001
1000000000000000000000001
111111111111111111111111

