
NO ./textures/cobble.xpm
SO ./textures/dirt.xpm
WE ./textures/wood.xpm
EA                         ./textures/gold.xpm


F             0,0,68
C 51,204,255


11111111111111111   11111
10000000000000011   11001
10000000000000001   10001
1000000000000000111110001
1000000000000000000000001
1000000000000000000000001
1000000000000000000000001
1000000000000000000000001
1000000000000000000000001
1000000000011110000000011111111111111111111111111111111111
1000000000000000000000000000000000000000000000000000000001
1000000000000100000000001111111111111111111111111111000011
1000000000000000000000001                          110011
100000111000000000000000111111111111               110011
10000001100000000000000000000000001                110011
1000000000000000000010001111110001111111111111111111000001
1000000000000000000000001    11000000000000000000000000001
1000001000000000000000001     10000000000000000000000000011
1000000000000000000000001      111111111111111111111111111
11111000000000010000000011111
    10000000000000000W0000001
11111000000000000000000011111
1000000000000000000000001
1000000000000000000000001
1111111111111111111111111
1

